1,1,1,1,1,1,1,1,1,1,1,1,1,1,1
1,2,0,0,0,0,0,0,1,0,0,0,0,0,1
1,0,1,1,1,0,1,0,1,0,1,1,1,0,1
1,0,0,0,0,0,1,0,1,0,1,0,1,0,1
1,1,1,1,1,0,1,0,0,0,1,0,1,0,1
1,0,0,0,0,0,0,0,1,1,1,0,1,0,1
1,0,1,0,1,1,1,0,1,0,0,0,1,0,1
1,0,1,0,0,0,1,13,1,0,1,0,1,0,1
1,0,1,0,0,0,1,0,1,0,1,0,1,0,1
1,0,1,1,1,0,1,0,0,0,1,0,0,0,1
1,0,0,0,1,0,0,0,1,1,1,1,1,0,1
1,0,1,0,0,0,1,0,1,0,0,0,0,0,1
1,0,1,1,1,0,1,0,1,0,1,1,1,0,1
1,0,0,0,1,0,0,0,0,0,0,0,0,7,1
1,1,1,1,1,1,1,1,1,1,1,1,1,1,1
